talk.politics.guns
israel	talk.politics.guns	talk.politics.mideast	323.0
turkish	talk.politics.guns	talk.politics.mideast	181.0
clayton	talk.politics.guns	talk.politics.misc	111.0
money	talk.politics.guns	talk.politics.misc	82.0
arab	talk.politics.guns	talk.politics.mideast	63.0
muslims	talk.politics.guns	talk.politics.mideast	46.0
president	talk.politics.guns	talk.politics.misc	40.0
israeli	talk.politics.guns	talk.politics.mideast	36.0
health	talk.politics.guns	talk.politics.misc	35.0
hallam	talk.politics.guns	talk.politics.misc	30.0
employer	talk.politics.guns	talk.politics.misc	29.0
kaldis	talk.politics.guns	talk.politics.misc	26.0
beyer	talk.politics.guns	talk.politics.mideast	20.0
gay	talk.politics.guns	talk.politics.misc	20.0
occupied	talk.politics.misc	talk.politics.mideast	18.0
phil	talk.politics.guns	talk.politics.misc	17.0
gun	talk.politics.misc	talk.politics.guns	16.0
thor	talk.politics.guns	talk.politics.misc	15.0
submit	talk.politics.guns	talk.politics.misc	13.0
boomer	talk.politics.guns	talk.politics.misc	12.0
teel	talk.politics.guns	talk.politics.misc	11.0
landreneau	talk.politics.guns	talk.politics.misc	11.0
racism	talk.politics.guns	talk.politics.mideast	11.0
ecn	talk.politics.guns	talk.politics.misc	11.0
danny	talk.politics.guns	talk.politics.mideast	10.0
athena	talk.politics.guns	talk.politics.misc	10.0
muslim	talk.politics.guns	talk.politics.mideast	10.0
deficit	talk.politics.guns	talk.politics.misc	9.0
alfalfa	talk.politics.guns	talk.politics.mideast	9.0
azoghlin	talk.politics.guns	talk.politics.misc	9.0
nasa	talk.politics.guns	talk.politics.misc	9.0
ncr	talk.politics.guns	talk.politics.misc	8.0
fourd	talk.politics.guns	talk.politics.mideast	8.0
drieux	talk.politics.guns	talk.politics.misc	7.0
cpr	talk.politics.guns	talk.politics.mideast	7.0
harry	talk.politics.guns	talk.politics.mideast	7.0
republicans	talk.politics.guns	talk.politics.misc	7.0
greek	talk.politics.guns	talk.politics.mideast	7.0
adl	talk.politics.guns	talk.politics.mideast	6.0
conveniently	talk.politics.guns	talk.politics.misc	6.0
seizures	talk.politics.guns	talk.politics.misc	6.0
ipser	talk.politics.guns	talk.politics.misc	6.0
margolis	talk.politics.guns	talk.politics.misc	5.0
whitehead	talk.politics.misc	talk.politics.guns	5.0
gordian	talk.politics.guns	talk.politics.misc	5.0
bosnia	talk.politics.guns	talk.politics.mideast	5.0
scharfy	talk.politics.guns	talk.politics.misc	5.0
adams	talk.politics.guns	talk.politics.misc	5.0
toxic	talk.politics.guns	talk.politics.misc	5.0
jupiter	talk.politics.misc	talk.politics.guns	5.0
reform	talk.politics.guns	talk.politics.misc	5.0
mohammad	talk.politics.misc	talk.politics.mideast	5.0
uta	talk.politics.guns	talk.politics.misc	4.0
gannon	talk.politics.guns	talk.politics.mideast	4.0
candidacy	talk.politics.misc	talk.politics.guns	4.0
jviv	talk.politics.guns	talk.politics.misc	4.0
mit	talk.politics.guns	talk.politics.mideast	4.0
morality	talk.politics.guns	talk.politics.misc	4.0
elias	talk.politics.guns	talk.politics.mideast	4.0
vat	talk.politics.guns	talk.politics.misc	4.0
batf	talk.politics.mideast	talk.politics.guns	4.0
frustrated	talk.politics.guns	talk.politics.misc	4.0
firearm	talk.politics.misc	talk.politics.guns	4.0
mow	talk.politics.guns	talk.politics.misc	4.0
armenians	talk.politics.guns	talk.politics.mideast	4.0
ingres	talk.politics.guns	talk.politics.misc	4.0
casper	talk.politics.guns	talk.politics.misc	4.0
landing	talk.politics.guns	talk.politics.misc	4.0
cigarettes	talk.politics.guns	talk.politics.misc	4.0
cult	talk.politics.mideast	talk.politics.misc	3.0
marc	talk.politics.guns	talk.politics.mideast	3.0
lerc	talk.politics.misc	talk.politics.guns	3.0
cen	talk.politics.guns	talk.politics.misc	3.0
holtsinger	talk.politics.guns	talk.politics.misc	3.0
censoring	talk.politics.misc	talk.politics.guns	3.0
conservatives	talk.politics.guns	talk.politics.misc	3.0
palestinian	talk.politics.guns	talk.politics.mideast	3.0
hk	talk.politics.mideast	talk.politics.guns	3.0
sw	talk.politics.misc	talk.politics.guns	3.0
herbert	talk.politics.guns	talk.politics.misc	3.0
carroll	talk.politics.guns	talk.politics.misc	3.0
holt	talk.politics.guns	talk.politics.misc	3.0
canal	talk.politics.guns	talk.politics.misc	3.0
hassan	talk.politics.guns	talk.politics.mideast	3.0
ucdavis	talk.politics.guns	talk.politics.mideast	3.0
optilink	talk.politics.guns	talk.politics.misc	3.0
schmidling	talk.politics.misc	talk.politics.mideast	3.0
arafat	talk.politics.guns	talk.politics.mideast	3.0
thessaloniki	talk.politics.guns	talk.politics.mideast	2.0
kuo	talk.politics.guns	talk.politics.misc	2.0
veal	talk.politics.mideast	talk.politics.misc	2.0
rouge	talk.politics.guns	talk.politics.mideast	2.0
fortress	talk.politics.mideast	talk.politics.guns	2.0
sanders	talk.politics.mideast	talk.politics.misc	2.0
censorship	talk.politics.mideast	talk.politics.misc	2.0
filipivich	talk.politics.guns	talk.politics.misc	2.0
pollution	talk.politics.guns	talk.politics.misc	2.0
torches	talk.politics.guns	talk.politics.misc	2.0
guise	talk.politics.guns	talk.politics.misc	2.0
neighboring	talk.politics.guns	talk.politics.misc	2.0
heterogeneous	talk.politics.guns	talk.politics.misc	2.0
israeli	talk.politics.misc	talk.politics.mideast	2.0
banning	talk.politics.mideast	talk.politics.guns	2.0
critiques	talk.politics.guns	talk.politics.misc	2.0
selectively	talk.politics.guns	talk.politics.mideast	2.0
fetus	talk.politics.guns	talk.politics.misc	2.0
allan	talk.politics.misc	talk.politics.guns	2.0
aussie	talk.politics.guns	talk.politics.misc	2.0
advisees	talk.politics.guns	talk.politics.mideast	2.0
goddam	talk.politics.misc	talk.politics.guns	2.0
articulate	talk.politics.guns	talk.politics.mideast	2.0
timucin	talk.politics.guns	talk.politics.mideast	2.0
succinct	talk.politics.misc	talk.politics.mideast	2.0
kriz	talk.politics.guns	talk.politics.misc	2.0
kayhan	talk.politics.misc	talk.politics.mideast	2.0
tyrannical	talk.politics.misc	talk.politics.guns	2.0
sporting	talk.politics.mideast	talk.politics.guns	2.0
knowledgeable	talk.politics.guns	talk.politics.misc	2.0
jew	talk.politics.guns	talk.politics.mideast	2.0
lutherans	talk.politics.mideast	talk.politics.guns	2.0
whughes	talk.politics.misc	talk.politics.guns	2.0
wente	talk.politics.guns	talk.politics.misc	2.0
nam	talk.politics.misc	talk.politics.guns	2.0
chrysler	talk.politics.guns	talk.politics.misc	2.0
condemening	talk.politics.guns	talk.politics.mideast	2.0
tesrt	talk.politics.guns	talk.politics.misc	2.0
wcyb	talk.politics.misc	talk.politics.guns	2.0
jesse	talk.politics.guns	talk.politics.mideast	2.0
stevethc	talk.politics.guns	talk.politics.misc	2.0
waco	talk.politics.mideast	talk.politics.misc	2.0
andy	talk.politics.misc	talk.politics.guns	2.0
orange	talk.politics.guns	talk.politics.misc	1.0
kabbalat	talk.politics.guns	talk.politics.mideast	1.0
lambasting	talk.politics.guns	talk.politics.mideast	1.0
implicit	talk.politics.guns	talk.politics.mideast	1.0
tabloids	talk.politics.mideast	talk.politics.misc	1.0
jsh	talk.politics.guns	talk.politics.misc	1.0
compounded	talk.politics.mideast	talk.politics.misc	1.0
jlpicard	talk.politics.misc	talk.politics.guns	1.0
kristofer	talk.politics.guns	talk.politics.misc	1.0
stimulus	talk.politics.guns	talk.politics.misc	1.0
vwp	talk.politics.guns	talk.politics.misc	1.0
mooneys	talk.politics.guns	talk.politics.misc	1.0
recollection	talk.politics.guns	talk.politics.mideast	1.0
watstar	talk.politics.guns	talk.politics.misc	1.0
vivaldi	talk.politics.mideast	talk.politics.guns	1.0
wolfram	talk.politics.guns	talk.politics.misc	1.0
footnoted	talk.politics.guns	talk.politics.mideast	1.0
jp	talk.politics.misc	talk.politics.guns	1.0
immigrant	talk.politics.guns	talk.politics.misc	1.0
cyberspace	talk.politics.guns	talk.politics.mideast	1.0
irrevelant	talk.politics.misc	talk.politics.guns	1.0
mavens	talk.politics.guns	talk.politics.misc	1.0
duff	talk.politics.misc	talk.politics.guns	1.0
chloupek	talk.politics.guns	talk.politics.misc	1.0
clarinet	talk.politics.guns	talk.politics.mideast	1.0
possiblility	talk.politics.guns	talk.politics.misc	1.0
ummmex	talk.politics.misc	talk.politics.guns	1.0
rolandi	talk.politics.guns	talk.politics.misc	1.0
misconstruction	talk.politics.guns	talk.politics.misc	1.0
crimminal	talk.politics.guns	talk.politics.misc	1.0
shannon	talk.politics.misc	talk.politics.guns	1.0
potatoes	talk.politics.guns	talk.politics.misc	1.0
algeria	talk.politics.misc	talk.politics.mideast	1.0
anouncements	talk.politics.guns	talk.politics.misc	1.0
scoutmaster	talk.politics.guns	talk.politics.misc	1.0
afghans	talk.politics.guns	talk.politics.misc	1.0
strangulation	talk.politics.guns	talk.politics.misc	1.0
spew	talk.politics.guns	talk.politics.misc	1.0
selanne	talk.politics.mideast	talk.politics.misc	1.0
tranquil	talk.politics.guns	talk.politics.mideast	1.0
jmk	talk.politics.guns	talk.politics.misc	1.0
blasphemous	talk.politics.guns	talk.politics.misc	1.0
cwinemil	talk.politics.guns	talk.politics.misc	1.0
revisit	talk.politics.guns	talk.politics.misc	1.0
mcimail	talk.politics.misc	talk.politics.guns	1.0
pocket	talk.politics.guns	talk.politics.misc	1.0
ncsl	talk.politics.misc	talk.politics.guns	1.0
harrassed	talk.politics.mideast	talk.politics.misc	1.0
allergic	talk.politics.guns	talk.politics.misc	1.0
recognition	talk.politics.guns	talk.politics.misc	1.0
subscribe	talk.politics.guns	talk.politics.misc	1.0
isis	talk.politics.mideast	talk.politics.misc	1.0
northeastern	talk.politics.guns	talk.politics.misc	1.0
franchise	talk.politics.mideast	talk.politics.misc	1.0
motorola	talk.politics.mideast	talk.politics.guns	1.0
peaceenforcement	talk.politics.guns	talk.politics.misc	1.0
gibson	talk.politics.guns	talk.politics.mideast	1.0
diplomatic	talk.politics.guns	talk.politics.misc	1.0
blah	talk.politics.guns	talk.politics.mideast	1.0
initiation	talk.politics.guns	talk.politics.misc	1.0
skies	talk.politics.guns	talk.politics.mideast	1.0
foaf	talk.politics.guns	talk.politics.misc	1.0
roam	talk.politics.guns	talk.politics.mideast	1.0
assasinated	talk.politics.guns	talk.politics.misc	1.0
crosmun	talk.politics.guns	talk.politics.misc	1.0
petro	talk.politics.misc	talk.politics.mideast	1.0
subordinates	talk.politics.misc	talk.politics.guns	1.0
curtail	talk.politics.guns	talk.politics.mideast	1.0
worldwide	talk.politics.guns	talk.politics.misc	1.0
jiq	talk.politics.misc	talk.politics.guns	1.0
smoker	talk.politics.guns	talk.politics.misc	1.0
wiscon	talk.politics.guns	talk.politics.mideast	1.0
mccarthy	talk.politics.guns	talk.politics.misc	1.0
demopublicans	talk.politics.guns	talk.politics.misc	1.0
anounced	talk.politics.misc	talk.politics.mideast	1.0
dodger	talk.politics.guns	talk.politics.misc	1.0
ault	talk.politics.guns	talk.politics.misc	1.0
epic	talk.politics.guns	talk.politics.misc	1.0
ttu	talk.politics.guns	talk.politics.misc	1.0
fixups	talk.politics.misc	talk.politics.guns	1.0
cole	talk.politics.guns	talk.politics.misc	1.0
bogglingly	talk.politics.guns	talk.politics.mideast	1.0
warnings	talk.politics.guns	talk.politics.misc	1.0
downside	talk.politics.guns	talk.politics.misc	1.0
basics	talk.politics.guns	talk.politics.mideast	1.0
nova	talk.politics.guns	talk.politics.mideast	1.0
turgur	talk.politics.mideast	talk.politics.misc	1.0
royce	talk.politics.misc	talk.politics.mideast	1.0
outer	talk.politics.guns	talk.politics.mideast	1.0
rnitedace	talk.politics.guns	talk.politics.misc	1.0
nyu	talk.politics.guns	talk.politics.misc	1.0
nabil	talk.politics.guns	talk.politics.mideast	1.0
bump	talk.politics.guns	talk.politics.misc	1.0
pubs	talk.politics.guns	talk.politics.misc	1.0
karadzic	talk.politics.guns	talk.politics.misc	1.0
zealous	talk.politics.guns	talk.politics.misc	1.0
glendenning	talk.politics.guns	talk.politics.misc	1.0
yugo	talk.politics.guns	talk.politics.misc	1.0
kramer	talk.politics.guns	talk.politics.mideast	1.0
awsome	talk.politics.guns	talk.politics.misc	1.0
restock	talk.politics.guns	talk.politics.mideast	1.0
kaufman	talk.politics.guns	talk.politics.mideast	1.0
bors	talk.politics.guns	talk.politics.misc	1.0
secured	talk.politics.guns	talk.politics.misc	1.0
myrto	talk.politics.misc	talk.politics.guns	1.0
czech	talk.politics.guns	talk.politics.misc	1.0
popped	talk.politics.guns	talk.politics.misc	1.0
weenie	talk.politics.guns	talk.politics.misc	1.0
regualar	talk.politics.guns	talk.politics.misc	1.0
rudman	talk.politics.guns	talk.politics.misc	1.0
spector	talk.politics.guns	talk.politics.misc	1.0
carpeting	talk.politics.mideast	talk.politics.misc	1.0
agrevates	talk.politics.guns	talk.politics.misc	1.0
propriety	talk.politics.guns	talk.politics.mideast	1.0
bellyaching	talk.politics.guns	talk.politics.misc	1.0
clammoring	talk.politics.misc	talk.politics.guns	1.0
andi	talk.politics.guns	talk.politics.mideast	1.0
fp	talk.politics.mideast	talk.politics.misc	1.0
picky	talk.politics.guns	talk.politics.mideast	1.0
chorus	talk.politics.guns	talk.politics.misc	1.0
vhs	talk.politics.guns	talk.politics.mideast	1.0
repost	talk.politics.guns	talk.politics.misc	1.0
basket	talk.politics.guns	talk.politics.mideast	1.0
sysadmin	talk.politics.guns	talk.politics.mideast	1.0
dne	talk.politics.misc	talk.politics.guns	1.0
reliably	talk.politics.misc	talk.politics.guns	0.0
